XXXXXXXXXX
X1 C  C2 X
XXHX  XX X
XCH    1 X
XXX HXHX X
X   H H  X
X   H HC2X
X HXX XXXX
XDH X   PX
XXXXXXXXXX