XXXXXXXXXX
X1PC 2  CX
X XXXXCHXX
X    XXHXX
X  C 3CH X
X HXXXXX X
X HDC X CX
X XXH X XX
XC12HDX3XX
XXXXXXXXXX