XXXXXXXXXX
X     1 4X
X2  C H  X
XXXXXXXX X
XC3    1 X
XXXX HXX X
XD   HCX X
XXX XXXXXX
X3C C4X2PX
XXXXXXXXXX